"filename", "language", "YAML", "Dart", "JSON", "XML", "comment", "blank", "total"
"c:\Users\oguzk\Desktop\visual studio\petilla_app_project\petilla_app_project\android\app\src\main\AndroidManifest.xml", "XML", 0, 0, 0, 2, 0, 0, 2
"c:\Users\oguzk\Desktop\visual studio\petilla_app_project\petilla_app_project\assets\jsons\lang\tr-TR.json", "JSON", 0, 0, 5, 0, 0, 0, 5
"c:\Users\oguzk\Desktop\visual studio\petilla_app_project\petilla_app_project\lib\core\components\textfields\main_textfield.dart", "Dart", 0, 3, 0, 0, 0, 0, 3
"c:\Users\oguzk\Desktop\visual studio\petilla_app_project\petilla_app_project\lib\core\constants\image\image_constants.dart", "Dart", 0, 1, 0, 0, 0, 0, 1
"c:\Users\oguzk\Desktop\visual studio\petilla_app_project\petilla_app_project\lib\core\constants\string_constant\app_firestore_field_names.dart", "Dart", 0, 4, 0, 0, 0, 0, 4
"c:\Users\oguzk\Desktop\visual studio\petilla_app_project\petilla_app_project\lib\core\constants\string_constant\project_firestore_collection_names.dart", "Dart", 0, 1, 0, 0, 0, 0, 1
"c:\Users\oguzk\Desktop\visual studio\petilla_app_project\petilla_app_project\lib\core\init\lang\locale_keys.g.dart", "Dart", 0, 5, 0, 0, 0, 0, 5
"c:\Users\oguzk\Desktop\visual studio\petilla_app_project\petilla_app_project\lib\core\init\theme\light_theme\light_theme_colors.dart", "Dart", 0, 1, 0, 0, 0, 0, 1
"c:\Users\oguzk\Desktop\visual studio\petilla_app_project\petilla_app_project\lib\view\admin\core\components\reported_pet_widget.dart", "Dart", 0, 40, 0, 0, 0, 4, 44
"c:\Users\oguzk\Desktop\visual studio\petilla_app_project\petilla_app_project\lib\view\admin\core\models\reported_pet_model.dart", "Dart", 0, 22, 0, 0, 0, 2, 24
"c:\Users\oguzk\Desktop\visual studio\petilla_app_project\petilla_app_project\lib\view\admin\view\admin_home_view.dart", "Dart", 0, 74, 0, 0, 1, 12, 87
"c:\Users\oguzk\Desktop\visual studio\petilla_app_project\petilla_app_project\lib\view\admin\viewmodel\admin_home_view_view_model.dart", "Dart", 0, 13, 0, 0, 1, 6, 20
"c:\Users\oguzk\Desktop\visual studio\petilla_app_project\petilla_app_project\lib\view\admin\viewmodel\admin_home_view_view_model.g.dart", "Dart", 0, 8, 0, 0, 5, 6, 19
"c:\Users\oguzk\Desktop\visual studio\petilla_app_project\petilla_app_project\lib\view\apps\main_petilla\core\components\chat_widgets\user_chat.dart", "Dart", 0, -44, 0, 0, -1, -6, -51
"c:\Users\oguzk\Desktop\visual studio\petilla_app_project\petilla_app_project\lib\view\apps\main_petilla\core\components\pet_widgets\large_pet_widget.dart", "Dart", 0, -198, 0, 0, -1, -23, -222
"c:\Users\oguzk\Desktop\visual studio\petilla_app_project\petilla_app_project\lib\view\apps\main_petilla\core\components\pet_widgets\normal_pet_widget.dart", "Dart", 0, -168, 0, 0, -1, -21, -190
"c:\Users\oguzk\Desktop\visual studio\petilla_app_project\petilla_app_project\lib\view\apps\main_petilla\service\chat_service\chat_service.dart", "Dart", 0, -67, 0, 0, 0, -4, -71
"c:\Users\oguzk\Desktop\visual studio\petilla_app_project\petilla_app_project\lib\view\apps\main_petilla\service\firebase_crud\crud_service.dart", "Dart", 0, -36, 0, 0, -1, -4, -41
"c:\Users\oguzk\Desktop\visual studio\petilla_app_project\petilla_app_project\lib\view\apps\main_petilla\service\models\jsons\city_model.dart", "Dart", 0, -36, 0, 0, 0, -10, -46
"c:\Users\oguzk\Desktop\visual studio\petilla_app_project\petilla_app_project\lib\view\apps\main_petilla\service\models\pet_model.dart", "Dart", 0, -32, 0, 0, 0, -2, -34
"c:\Users\oguzk\Desktop\visual studio\petilla_app_project\petilla_app_project\lib\view\apps\main_petilla\service\storage_service.dart\storage_crud.dart", "Dart", 0, -21, 0, 0, 0, -5, -26
"c:\Users\oguzk\Desktop\visual studio\petilla_app_project\petilla_app_project\lib\view\apps\main_petilla\view\add_view.dart", "Dart", 0, -241, 0, 0, -6, -24, -271
"c:\Users\oguzk\Desktop\visual studio\petilla_app_project\petilla_app_project\lib\view\apps\main_petilla\view\add_view_two.dart", "Dart", 0, -352, 0, 0, -1, -42, -395
"c:\Users\oguzk\Desktop\visual studio\petilla_app_project\petilla_app_project\lib\view\apps\main_petilla\view\chat_select_view.dart", "Dart", 0, -87, 0, 0, -1, -15, -103
"c:\Users\oguzk\Desktop\visual studio\petilla_app_project\petilla_app_project\lib\view\apps\main_petilla\view\city_select_view.dart", "Dart", 0, -29, 0, 0, -1, -4, -34
"c:\Users\oguzk\Desktop\visual studio\petilla_app_project\petilla_app_project\lib\view\apps\main_petilla\view\favorites_view.dart", "Dart", 0, -112, 0, 0, -1, -18, -131
"c:\Users\oguzk\Desktop\visual studio\petilla_app_project\petilla_app_project\lib\view\apps\main_petilla\view\ilce_select_view.dart", "Dart", 0, -33, 0, 0, -1, -8, -42
"c:\Users\oguzk\Desktop\visual studio\petilla_app_project\petilla_app_project\lib\view\apps\main_petilla\view\in_chat_view.dart", "Dart", 0, -182, 0, 0, 0, -20, -202
"c:\Users\oguzk\Desktop\visual studio\petilla_app_project\petilla_app_project\lib\view\apps\main_petilla\view\main_petilla.dart", "Dart", 0, -89, 0, 0, 0, -15, -104
"c:\Users\oguzk\Desktop\visual studio\petilla_app_project\petilla_app_project\lib\view\apps\main_petilla\view\other_profile_view.dart", "Dart", 0, -93, 0, 0, -1, -15, -109
"c:\Users\oguzk\Desktop\visual studio\petilla_app_project\petilla_app_project\lib\view\apps\main_petilla\view\petilla_detail_view.dart", "Dart", 0, -197, 0, 0, 0, -27, -224
"c:\Users\oguzk\Desktop\visual studio\petilla_app_project\petilla_app_project\lib\view\apps\main_petilla\view\petilla_home_view.dart", "Dart", 0, -392, 0, 0, 0, -34, -426
"c:\Users\oguzk\Desktop\visual studio\petilla_app_project\petilla_app_project\lib\view\apps\main_petilla\view\petilla_insert_view.dart", "Dart", 0, -101, 0, 0, 0, -15, -116
"c:\Users\oguzk\Desktop\visual studio\petilla_app_project\petilla_app_project\lib\view\apps\main_petilla\viewmodel\add_view_two_view_model.dart", "Dart", 0, -65, 0, 0, -1, -7, -73
"c:\Users\oguzk\Desktop\visual studio\petilla_app_project\petilla_app_project\lib\view\apps\main_petilla\viewmodel\add_view_two_view_model.g.dart", "Dart", 0, -44, 0, 0, -5, -8, -57
"c:\Users\oguzk\Desktop\visual studio\petilla_app_project\petilla_app_project\lib\view\apps\main_petilla\viewmodel\add_view_view_model.dart", "Dart", 0, -51, 0, 0, -1, -13, -65
"c:\Users\oguzk\Desktop\visual studio\petilla_app_project\petilla_app_project\lib\view\apps\main_petilla\viewmodel\add_view_view_model.g.dart", "Dart", 0, -61, 0, 0, -5, -17, -83
"c:\Users\oguzk\Desktop\visual studio\petilla_app_project\petilla_app_project\lib\view\apps\main_petilla\viewmodel\chat_select_view_model.dart", "Dart", 0, -51, 0, 0, -1, -8, -60
"c:\Users\oguzk\Desktop\visual studio\petilla_app_project\petilla_app_project\lib\view\apps\main_petilla\viewmodel\chat_select_view_model.g.dart", "Dart", 0, -38, 0, 0, -5, -9, -52
"c:\Users\oguzk\Desktop\visual studio\petilla_app_project\petilla_app_project\lib\view\apps\main_petilla\viewmodel\favorites_view_view_model.dart", "Dart", 0, -30, 0, 0, -1, -11, -42
"c:\Users\oguzk\Desktop\visual studio\petilla_app_project\petilla_app_project\lib\view\apps\main_petilla\viewmodel\favorites_view_view_model.g.dart", "Dart", 0, -56, 0, 0, -5, -16, -77
"c:\Users\oguzk\Desktop\visual studio\petilla_app_project\petilla_app_project\lib\view\apps\main_petilla\viewmodel\in_chat_view_view_model.dart", "Dart", 0, -36, 0, 0, -1, -7, -44
"c:\Users\oguzk\Desktop\visual studio\petilla_app_project\petilla_app_project\lib\view\apps\main_petilla\viewmodel\in_chat_view_view_model.g.dart", "Dart", 0, -28, 0, 0, -5, -8, -41
"c:\Users\oguzk\Desktop\visual studio\petilla_app_project\petilla_app_project\lib\view\apps\main_petilla\viewmodel\main_petilla_view_model.dart", "Dart", 0, -13, 0, 0, -1, -6, -20
"c:\Users\oguzk\Desktop\visual studio\petilla_app_project\petilla_app_project\lib\view\apps\main_petilla\viewmodel\main_petilla_view_model.g.dart", "Dart", 0, -8, 0, 0, -5, -6, -19
"c:\Users\oguzk\Desktop\visual studio\petilla_app_project\petilla_app_project\lib\view\apps\main_petilla\viewmodel\other_profile_view_view_model.dart", "Dart", 0, -13, 0, 0, -1, -6, -20
"c:\Users\oguzk\Desktop\visual studio\petilla_app_project\petilla_app_project\lib\view\apps\main_petilla\viewmodel\other_profile_view_view_model.g.dart", "Dart", 0, -8, 0, 0, -5, -6, -19
"c:\Users\oguzk\Desktop\visual studio\petilla_app_project\petilla_app_project\lib\view\apps\main_petilla\viewmodel\petilla_detail_view_view_model.dart", "Dart", 0, -49, 0, 0, -1, -12, -62
"c:\Users\oguzk\Desktop\visual studio\petilla_app_project\petilla_app_project\lib\view\apps\main_petilla\viewmodel\petilla_detail_view_view_model.g.dart", "Dart", 0, -60, 0, 0, -5, -18, -83
"c:\Users\oguzk\Desktop\visual studio\petilla_app_project\petilla_app_project\lib\view\apps\pet_form\main_pet_form.dart", "Dart", 0, -9, 0, 0, 0, -3, -12
"c:\Users\oguzk\Desktop\visual studio\petilla_app_project\petilla_app_project\lib\view\apps\pet_form\service\group_message_service.dart", "Dart", 0, -17, 0, 0, 0, -2, -19
"c:\Users\oguzk\Desktop\visual studio\petilla_app_project\petilla_app_project\lib\view\apps\pet_form\view\group_template_view.dart", "Dart", 0, -183, 0, 0, 0, -23, -206
"c:\Users\oguzk\Desktop\visual studio\petilla_app_project\petilla_app_project\lib\view\apps\pet_form\view\petform_home_view.dart", "Dart", 0, -139, 0, 0, -1, -18, -158
"c:\Users\oguzk\Desktop\visual studio\petilla_app_project\petilla_app_project\lib\view\apps\pet_form\viewmodel\group_template_view_model.dart", "Dart", 0, -27, 0, 0, -1, -8, -36
"c:\Users\oguzk\Desktop\visual studio\petilla_app_project\petilla_app_project\lib\view\apps\pet_form\viewmodel\group_template_view_model.g.dart", "Dart", 0, -30, 0, 0, -5, -9, -44
"c:\Users\oguzk\Desktop\visual studio\petilla_app_project\petilla_app_project\lib\view\apps\pet_form\viewmodel\petform_home_view_model.dart", "Dart", 0, -34, 0, 0, 0, -6, -40
"c:\Users\oguzk\Desktop\visual studio\petilla_app_project\petilla_app_project\lib\view\apps\pet_form\viewmodel\petform_home_view_model.g.dart", "Dart", 0, -22, 0, 0, -5, -8, -35
"c:\Users\oguzk\Desktop\visual studio\petilla_app_project\petilla_app_project\lib\view\auth\onboard\view\onboarding.dart", "Dart", 0, -137, 0, 0, -3, -20, -160
"c:\Users\oguzk\Desktop\visual studio\petilla_app_project\petilla_app_project\lib\view\auth\onboard\view\onboarding_one_view.dart", "Dart", 0, -40, 0, 0, -1, -6, -47
"c:\Users\oguzk\Desktop\visual studio\petilla_app_project\petilla_app_project\lib\view\auth\onboard\view\onboarding_three_view.dart", "Dart", 0, -40, 0, 0, -1, -7, -48
"c:\Users\oguzk\Desktop\visual studio\petilla_app_project\petilla_app_project\lib\view\auth\onboard\view\onboarding_two_view.dart", "Dart", 0, -40, 0, 0, -1, -7, -48
"c:\Users\oguzk\Desktop\visual studio\petilla_app_project\petilla_app_project\lib\view\auth\onboard\viewmodel\onboarding_view_model.dart", "Dart", 0, -14, 0, 0, 0, -2, -16
"c:\Users\oguzk\Desktop\visual studio\petilla_app_project\petilla_app_project\lib\view\auth\service\auth_service.dart", "Dart", 0, -40, 0, 0, 0, -6, -46
"c:\Users\oguzk\Desktop\visual studio\petilla_app_project\petilla_app_project\lib\view\auth\view\login_view.dart", "Dart", 0, -126, 0, 0, -1, -17, -144
"c:\Users\oguzk\Desktop\visual studio\petilla_app_project\petilla_app_project\lib\view\auth\view\register_view.dart", "Dart", 0, -137, 0, 0, -1, -20, -158
"c:\Users\oguzk\Desktop\visual studio\petilla_app_project\petilla_app_project\lib\view\auth\viewmodel\login_view_model.dart", "Dart", 0, -22, 0, 0, 0, -2, -24
"c:\Users\oguzk\Desktop\visual studio\petilla_app_project\petilla_app_project\lib\view\auth\viewmodel\register_view_model.dart", "Dart", 0, -23, 0, 0, 0, -2, -25
"c:\Users\oguzk\Desktop\visual studio\petilla_app_project\petilla_app_project\lib\view\start\core\components\select_app_widget.dart", "Dart", 0, -60, 0, 0, 0, -7, -67
"c:\Users\oguzk\Desktop\visual studio\petilla_app_project\petilla_app_project\lib\view\start\view\select_app_view.dart", "Dart", 0, -121, 0, 0, 0, -15, -136
"c:\Users\oguzk\Desktop\visual studio\petilla_app_project\petilla_app_project\lib\view\start\viewmodel\select_app_view_model.dart", "Dart", 0, 0, 0, 0, 0, -2, -2
"c:\Users\oguzk\Desktop\visual studio\petilla_app_project\petilla_app_project\lib\view\user\apps\animal_report\view\animal_report_home_view.dart", "Dart", 0, 284, 0, 0, 0, 29, 313
"c:\Users\oguzk\Desktop\visual studio\petilla_app_project\petilla_app_project\lib\view\user\apps\animal_report\view\main_animal_report.dart", "Dart", 0, 9, 0, 0, 0, 3, 12
"c:\Users\oguzk\Desktop\visual studio\petilla_app_project\petilla_app_project\lib\view\user\apps\animal_report\viewmodel\animal_report_home_view_view_model.dart", "Dart", 0, 78, 0, 0, 1, 15, 94
"c:\Users\oguzk\Desktop\visual studio\petilla_app_project\petilla_app_project\lib\view\user\apps\animal_report\viewmodel\animal_report_home_view_view_model.g.dart", "Dart", 0, 86, 0, 0, 5, 22, 113
"c:\Users\oguzk\Desktop\visual studio\petilla_app_project\petilla_app_project\lib\view\user\apps\main_petilla\core\components\chat_widgets\user_chat.dart", "Dart", 0, 44, 0, 0, 1, 6, 51
"c:\Users\oguzk\Desktop\visual studio\petilla_app_project\petilla_app_project\lib\view\user\apps\main_petilla\core\components\pet_widgets\large_pet_widget.dart", "Dart", 0, 198, 0, 0, 1, 23, 222
"c:\Users\oguzk\Desktop\visual studio\petilla_app_project\petilla_app_project\lib\view\user\apps\main_petilla\core\components\pet_widgets\normal_pet_widget.dart", "Dart", 0, 167, 0, 0, 1, 21, 189
"c:\Users\oguzk\Desktop\visual studio\petilla_app_project\petilla_app_project\lib\view\user\apps\main_petilla\service\chat_service\chat_service.dart", "Dart", 0, 67, 0, 0, 0, 4, 71
"c:\Users\oguzk\Desktop\visual studio\petilla_app_project\petilla_app_project\lib\view\user\apps\main_petilla\service\firebase_crud\crud_service.dart", "Dart", 0, 36, 0, 0, 1, 4, 41
"c:\Users\oguzk\Desktop\visual studio\petilla_app_project\petilla_app_project\lib\view\user\apps\main_petilla\service\models\jsons\city_model.dart", "Dart", 0, 36, 0, 0, 0, 10, 46
"c:\Users\oguzk\Desktop\visual studio\petilla_app_project\petilla_app_project\lib\view\user\apps\main_petilla\service\models\pet_model.dart", "Dart", 0, 32, 0, 0, 0, 2, 34
"c:\Users\oguzk\Desktop\visual studio\petilla_app_project\petilla_app_project\lib\view\user\apps\main_petilla\service\storage_service.dart\storage_crud.dart", "Dart", 0, 20, 0, 0, 0, 5, 25
"c:\Users\oguzk\Desktop\visual studio\petilla_app_project\petilla_app_project\lib\view\user\apps\main_petilla\view\add_view.dart", "Dart", 0, 241, 0, 0, 4, 24, 269
"c:\Users\oguzk\Desktop\visual studio\petilla_app_project\petilla_app_project\lib\view\user\apps\main_petilla\view\add_view_two.dart", "Dart", 0, 352, 0, 0, 1, 42, 395
"c:\Users\oguzk\Desktop\visual studio\petilla_app_project\petilla_app_project\lib\view\user\apps\main_petilla\view\chat_select_view.dart", "Dart", 0, 87, 0, 0, 1, 15, 103
"c:\Users\oguzk\Desktop\visual studio\petilla_app_project\petilla_app_project\lib\view\user\apps\main_petilla\view\city_select_view.dart", "Dart", 0, 29, 0, 0, 1, 4, 34
"c:\Users\oguzk\Desktop\visual studio\petilla_app_project\petilla_app_project\lib\view\user\apps\main_petilla\view\favorites_view.dart", "Dart", 0, 112, 0, 0, 1, 18, 131
"c:\Users\oguzk\Desktop\visual studio\petilla_app_project\petilla_app_project\lib\view\user\apps\main_petilla\view\ilce_select_view.dart", "Dart", 0, 33, 0, 0, 1, 8, 42
"c:\Users\oguzk\Desktop\visual studio\petilla_app_project\petilla_app_project\lib\view\user\apps\main_petilla\view\in_chat_view.dart", "Dart", 0, 182, 0, 0, 0, 20, 202
"c:\Users\oguzk\Desktop\visual studio\petilla_app_project\petilla_app_project\lib\view\user\apps\main_petilla\view\main_petilla.dart", "Dart", 0, 89, 0, 0, 0, 15, 104
"c:\Users\oguzk\Desktop\visual studio\petilla_app_project\petilla_app_project\lib\view\user\apps\main_petilla\view\other_profile_view.dart", "Dart", 0, 93, 0, 0, 1, 15, 109
"c:\Users\oguzk\Desktop\visual studio\petilla_app_project\petilla_app_project\lib\view\user\apps\main_petilla\view\petilla_detail_view.dart", "Dart", 0, 197, 0, 0, 0, 27, 224
"c:\Users\oguzk\Desktop\visual studio\petilla_app_project\petilla_app_project\lib\view\user\apps\main_petilla\view\petilla_home_view.dart", "Dart", 0, 392, 0, 0, 0, 34, 426
"c:\Users\oguzk\Desktop\visual studio\petilla_app_project\petilla_app_project\lib\view\user\apps\main_petilla\view\petilla_insert_view.dart", "Dart", 0, 101, 0, 0, 0, 15, 116
"c:\Users\oguzk\Desktop\visual studio\petilla_app_project\petilla_app_project\lib\view\user\apps\main_petilla\viewmodel\add_view_two_view_model.dart", "Dart", 0, 66, 0, 0, 1, 7, 74
"c:\Users\oguzk\Desktop\visual studio\petilla_app_project\petilla_app_project\lib\view\user\apps\main_petilla\viewmodel\add_view_two_view_model.g.dart", "Dart", 0, 44, 0, 0, 5, 8, 57
"c:\Users\oguzk\Desktop\visual studio\petilla_app_project\petilla_app_project\lib\view\user\apps\main_petilla\viewmodel\add_view_view_model.dart", "Dart", 0, 51, 0, 0, 1, 13, 65
"c:\Users\oguzk\Desktop\visual studio\petilla_app_project\petilla_app_project\lib\view\user\apps\main_petilla\viewmodel\add_view_view_model.g.dart", "Dart", 0, 61, 0, 0, 5, 17, 83
"c:\Users\oguzk\Desktop\visual studio\petilla_app_project\petilla_app_project\lib\view\user\apps\main_petilla\viewmodel\chat_select_view_model.dart", "Dart", 0, 51, 0, 0, 1, 8, 60
"c:\Users\oguzk\Desktop\visual studio\petilla_app_project\petilla_app_project\lib\view\user\apps\main_petilla\viewmodel\chat_select_view_model.g.dart", "Dart", 0, 38, 0, 0, 5, 9, 52
"c:\Users\oguzk\Desktop\visual studio\petilla_app_project\petilla_app_project\lib\view\user\apps\main_petilla\viewmodel\favorites_view_view_model.dart", "Dart", 0, 30, 0, 0, 1, 11, 42
"c:\Users\oguzk\Desktop\visual studio\petilla_app_project\petilla_app_project\lib\view\user\apps\main_petilla\viewmodel\favorites_view_view_model.g.dart", "Dart", 0, 56, 0, 0, 5, 16, 77
"c:\Users\oguzk\Desktop\visual studio\petilla_app_project\petilla_app_project\lib\view\user\apps\main_petilla\viewmodel\in_chat_view_view_model.dart", "Dart", 0, 36, 0, 0, 1, 7, 44
"c:\Users\oguzk\Desktop\visual studio\petilla_app_project\petilla_app_project\lib\view\user\apps\main_petilla\viewmodel\in_chat_view_view_model.g.dart", "Dart", 0, 28, 0, 0, 5, 8, 41
"c:\Users\oguzk\Desktop\visual studio\petilla_app_project\petilla_app_project\lib\view\user\apps\main_petilla\viewmodel\main_petilla_view_model.dart", "Dart", 0, 13, 0, 0, 1, 6, 20
"c:\Users\oguzk\Desktop\visual studio\petilla_app_project\petilla_app_project\lib\view\user\apps\main_petilla\viewmodel\main_petilla_view_model.g.dart", "Dart", 0, 8, 0, 0, 5, 6, 19
"c:\Users\oguzk\Desktop\visual studio\petilla_app_project\petilla_app_project\lib\view\user\apps\main_petilla\viewmodel\other_profile_view_view_model.dart", "Dart", 0, 13, 0, 0, 1, 6, 20
"c:\Users\oguzk\Desktop\visual studio\petilla_app_project\petilla_app_project\lib\view\user\apps\main_petilla\viewmodel\other_profile_view_view_model.g.dart", "Dart", 0, 8, 0, 0, 5, 6, 19
"c:\Users\oguzk\Desktop\visual studio\petilla_app_project\petilla_app_project\lib\view\user\apps\main_petilla\viewmodel\petilla_detail_view_view_model.dart", "Dart", 0, 49, 0, 0, 1, 12, 62
"c:\Users\oguzk\Desktop\visual studio\petilla_app_project\petilla_app_project\lib\view\user\apps\main_petilla\viewmodel\petilla_detail_view_view_model.g.dart", "Dart", 0, 60, 0, 0, 5, 18, 83
"c:\Users\oguzk\Desktop\visual studio\petilla_app_project\petilla_app_project\lib\view\user\apps\pet_form\main_pet_form.dart", "Dart", 0, 9, 0, 0, 0, 3, 12
"c:\Users\oguzk\Desktop\visual studio\petilla_app_project\petilla_app_project\lib\view\user\apps\pet_form\service\group_message_service.dart", "Dart", 0, 17, 0, 0, 0, 2, 19
"c:\Users\oguzk\Desktop\visual studio\petilla_app_project\petilla_app_project\lib\view\user\apps\pet_form\view\group_template_view.dart", "Dart", 0, 183, 0, 0, 0, 23, 206
"c:\Users\oguzk\Desktop\visual studio\petilla_app_project\petilla_app_project\lib\view\user\apps\pet_form\view\petform_home_view.dart", "Dart", 0, 139, 0, 0, 1, 18, 158
"c:\Users\oguzk\Desktop\visual studio\petilla_app_project\petilla_app_project\lib\view\user\apps\pet_form\viewmodel\group_template_view_model.dart", "Dart", 0, 27, 0, 0, 1, 8, 36
"c:\Users\oguzk\Desktop\visual studio\petilla_app_project\petilla_app_project\lib\view\user\apps\pet_form\viewmodel\group_template_view_model.g.dart", "Dart", 0, 30, 0, 0, 5, 9, 44
"c:\Users\oguzk\Desktop\visual studio\petilla_app_project\petilla_app_project\lib\view\user\apps\pet_form\viewmodel\petform_home_view_model.dart", "Dart", 0, 34, 0, 0, 0, 6, 40
"c:\Users\oguzk\Desktop\visual studio\petilla_app_project\petilla_app_project\lib\view\user\apps\pet_form\viewmodel\petform_home_view_model.g.dart", "Dart", 0, 22, 0, 0, 5, 8, 35
"c:\Users\oguzk\Desktop\visual studio\petilla_app_project\petilla_app_project\lib\view\user\auth\onboard\view\onboarding.dart", "Dart", 0, 137, 0, 0, 3, 20, 160
"c:\Users\oguzk\Desktop\visual studio\petilla_app_project\petilla_app_project\lib\view\user\auth\onboard\view\onboarding_one_view.dart", "Dart", 0, 40, 0, 0, 1, 6, 47
"c:\Users\oguzk\Desktop\visual studio\petilla_app_project\petilla_app_project\lib\view\user\auth\onboard\view\onboarding_three_view.dart", "Dart", 0, 40, 0, 0, 1, 7, 48
"c:\Users\oguzk\Desktop\visual studio\petilla_app_project\petilla_app_project\lib\view\user\auth\onboard\view\onboarding_two_view.dart", "Dart", 0, 40, 0, 0, 1, 7, 48
"c:\Users\oguzk\Desktop\visual studio\petilla_app_project\petilla_app_project\lib\view\user\auth\onboard\viewmodel\onboarding_view_model.dart", "Dart", 0, 14, 0, 0, 0, 2, 16
"c:\Users\oguzk\Desktop\visual studio\petilla_app_project\petilla_app_project\lib\view\user\auth\service\auth_service.dart", "Dart", 0, 40, 0, 0, 0, 6, 46
"c:\Users\oguzk\Desktop\visual studio\petilla_app_project\petilla_app_project\lib\view\user\auth\view\login_view.dart", "Dart", 0, 156, 0, 0, 1, 19, 176
"c:\Users\oguzk\Desktop\visual studio\petilla_app_project\petilla_app_project\lib\view\user\auth\view\register_view.dart", "Dart", 0, 137, 0, 0, 1, 20, 158
"c:\Users\oguzk\Desktop\visual studio\petilla_app_project\petilla_app_project\lib\view\user\auth\viewmodel\login_view_model.dart", "Dart", 0, 22, 0, 0, 0, 2, 24
"c:\Users\oguzk\Desktop\visual studio\petilla_app_project\petilla_app_project\lib\view\user\auth\viewmodel\register_view_model.dart", "Dart", 0, 23, 0, 0, 0, 2, 25
"c:\Users\oguzk\Desktop\visual studio\petilla_app_project\petilla_app_project\lib\view\user\start\core\components\select_app_widget.dart", "Dart", 0, 60, 0, 0, 0, 7, 67
"c:\Users\oguzk\Desktop\visual studio\petilla_app_project\petilla_app_project\lib\view\user\start\view\select_app_view.dart", "Dart", 0, 129, 0, 0, 1, 17, 147
"c:\Users\oguzk\Desktop\visual studio\petilla_app_project\petilla_app_project\lib\view\user\start\viewmodel\select_app_view_view_model.dart", "Dart", 0, 18, 0, 0, 1, 6, 25
"c:\Users\oguzk\Desktop\visual studio\petilla_app_project\petilla_app_project\lib\view\user\start\viewmodel\select_app_view_view_model.g.dart", "Dart", 0, 20, 0, 0, 5, 8, 33
"c:\Users\oguzk\Desktop\visual studio\petilla_app_project\petilla_app_project\pubspec.yaml", "YAML", 3, 0, 0, 0, 1, 1, 5
"Total", "-", 3, 704, 5, 2, 19, 116, 849