"filename", "language", "YAML", "JSON", "Shell Script", "Markdown", "Dart", "comment", "blank", "total"
"c:\Users\oguzk\Desktop\visual studio\petilla_app_project\petilla_app_project\README.md", "Markdown", 0, 0, 0, 10, 0, 0, 10, 20
"c:\Users\oguzk\Desktop\visual studio\petilla_app_project\petilla_app_project\assets\jsons\lang\tr-TR.json", "JSON", 0, 75, 0, 0, 0, 0, 0, 75
"c:\Users\oguzk\Desktop\visual studio\petilla_app_project\petilla_app_project\assets\jsons\localization\tr-TR.json", "JSON", 0, -73, 0, 0, 0, 0, 0, -73
"c:\Users\oguzk\Desktop\visual studio\petilla_app_project\petilla_app_project\lib\apps\main_petilla\core\components\chat_widgets\user_chat.dart", "Dart", 0, 0, 0, 0, 41, 1, 6, 48
"c:\Users\oguzk\Desktop\visual studio\petilla_app_project\petilla_app_project\lib\apps\main_petilla\core\components\pet_widgets\large_pet_widget.dart", "Dart", 0, 0, 0, 0, 198, 1, 24, 223
"c:\Users\oguzk\Desktop\visual studio\petilla_app_project\petilla_app_project\lib\apps\main_petilla\core\components\pet_widgets\normal_pet_widget.dart", "Dart", 0, 0, 0, 0, 169, 1, 21, 191
"c:\Users\oguzk\Desktop\visual studio\petilla_app_project\petilla_app_project\lib\apps\main_petilla\main_petilla.dart", "Dart", 0, 0, 0, 0, 2, 0, 0, 2
"c:\Users\oguzk\Desktop\visual studio\petilla_app_project\petilla_app_project\lib\apps\main_petilla\petilla_main_service\chat_service\chat_service.dart", "Dart", 0, 0, 0, 0, -67, 0, -4, -71
"c:\Users\oguzk\Desktop\visual studio\petilla_app_project\petilla_app_project\lib\apps\main_petilla\petilla_main_service\firebase_crud\crud_service.dart", "Dart", 0, 0, 0, 0, -36, -1, -4, -41
"c:\Users\oguzk\Desktop\visual studio\petilla_app_project\petilla_app_project\lib\apps\main_petilla\petilla_main_service\models\jsons\city_model.dart", "Dart", 0, 0, 0, 0, -36, 0, -10, -46
"c:\Users\oguzk\Desktop\visual studio\petilla_app_project\petilla_app_project\lib\apps\main_petilla\petilla_main_service\models\pet_model.dart", "Dart", 0, 0, 0, 0, -32, 0, -2, -34
"c:\Users\oguzk\Desktop\visual studio\petilla_app_project\petilla_app_project\lib\apps\main_petilla\petilla_main_service\storage_service.dart\storage_crud.dart", "Dart", 0, 0, 0, 0, -21, 0, -5, -26
"c:\Users\oguzk\Desktop\visual studio\petilla_app_project\petilla_app_project\lib\apps\main_petilla\petilla_main_view\main_view\add_view\add_view\add_view.dart", "Dart", 0, 0, 0, 0, -244, -4, -26, -274
"c:\Users\oguzk\Desktop\visual studio\petilla_app_project\petilla_app_project\lib\apps\main_petilla\petilla_main_view\main_view\add_view\add_view\add_view_model.dart", "Dart", 0, 0, 0, 0, -16, 0, -2, -18
"c:\Users\oguzk\Desktop\visual studio\petilla_app_project\petilla_app_project\lib\apps\main_petilla\petilla_main_view\main_view\add_view\add_view_two\add_view_two.dart", "Dart", 0, 0, 0, 0, -372, -1, -42, -415
"c:\Users\oguzk\Desktop\visual studio\petilla_app_project\petilla_app_project\lib\apps\main_petilla\petilla_main_view\main_view\add_view\add_view_two\add_view_two_view_model.dart", "Dart", 0, 0, 0, 0, -1, 0, -1, -2
"c:\Users\oguzk\Desktop\visual studio\petilla_app_project\petilla_app_project\lib\apps\main_petilla\petilla_main_view\main_view\add_view\city\city_select_view.dart", "Dart", 0, 0, 0, 0, -33, -1, -5, -39
"c:\Users\oguzk\Desktop\visual studio\petilla_app_project\petilla_app_project\lib\apps\main_petilla\petilla_main_view\main_view\add_view\city\ilce_select_view.dart", "Dart", 0, 0, 0, 0, -33, -1, -8, -42
"c:\Users\oguzk\Desktop\visual studio\petilla_app_project\petilla_app_project\lib\apps\main_petilla\petilla_main_view\main_view\favorites_view\favorites_view.dart", "Dart", 0, 0, 0, 0, -110, 0, -15, -125
"c:\Users\oguzk\Desktop\visual studio\petilla_app_project\petilla_app_project\lib\apps\main_petilla\petilla_main_view\main_view\petilla_home_view\petilla_home_view.dart", "Dart", 0, 0, 0, 0, -389, 0, -31, -420
"c:\Users\oguzk\Desktop\visual studio\petilla_app_project\petilla_app_project\lib\apps\main_petilla\petilla_main_view\main_view\petilla_home_view\petilla_home_view_model.dart", "Dart", 0, 0, 0, 0, 0, 0, -2, -2
"c:\Users\oguzk\Desktop\visual studio\petilla_app_project\petilla_app_project\lib\apps\main_petilla\petilla_main_view\main_view\petilla_insert_view\petilla_insert_view.dart", "Dart", 0, 0, 0, 0, -100, 0, -12, -112
"c:\Users\oguzk\Desktop\visual studio\petilla_app_project\petilla_app_project\lib\apps\main_petilla\petilla_main_view\main_view\petilla_insert_view\petilla_insert_view_model.dart", "Dart", 0, 0, 0, 0, 0, 0, -2, -2
"c:\Users\oguzk\Desktop\visual studio\petilla_app_project\petilla_app_project\lib\apps\main_petilla\petilla_main_view\main_view\petilla_main_chats\chat_select_view.dart", "Dart", 0, 0, 0, 0, -115, 0, -12, -127
"c:\Users\oguzk\Desktop\visual studio\petilla_app_project\petilla_app_project\lib\apps\main_petilla\petilla_main_view\main_view\petilla_main_chats\in_chat_view.dart", "Dart", 0, 0, 0, 0, -178, 0, -19, -197
"c:\Users\oguzk\Desktop\visual studio\petilla_app_project\petilla_app_project\lib\apps\main_petilla\petilla_main_view\other_view\petilla_detail_view\petilla_detail_view.dart", "Dart", 0, 0, 0, 0, -197, 0, -31, -228
"c:\Users\oguzk\Desktop\visual studio\petilla_app_project\petilla_app_project\lib\apps\main_petilla\petilla_main_view\other_view\petilla_detail_view\petilla_detail_view_model.dart", "Dart", 0, 0, 0, 0, -1, 0, -1, -2
"c:\Users\oguzk\Desktop\visual studio\petilla_app_project\petilla_app_project\lib\apps\main_petilla\petilla_main_view\petilla_main_widgets\chat_widgets\user_chat.dart", "Dart", 0, 0, 0, 0, -41, -1, -6, -48
"c:\Users\oguzk\Desktop\visual studio\petilla_app_project\petilla_app_project\lib\apps\main_petilla\petilla_main_view\petilla_main_widgets\pet_widgets\large_pet_widget.dart", "Dart", 0, 0, 0, 0, -201, -1, -23, -225
"c:\Users\oguzk\Desktop\visual studio\petilla_app_project\petilla_app_project\lib\apps\main_petilla\petilla_main_view\petilla_main_widgets\pet_widgets\normal_pet_widget.dart", "Dart", 0, 0, 0, 0, -194, -1, -21, -216
"c:\Users\oguzk\Desktop\visual studio\petilla_app_project\petilla_app_project\lib\apps\main_petilla\service\chat_service\chat_service.dart", "Dart", 0, 0, 0, 0, 67, 0, 4, 71
"c:\Users\oguzk\Desktop\visual studio\petilla_app_project\petilla_app_project\lib\apps\main_petilla\service\firebase_crud\crud_service.dart", "Dart", 0, 0, 0, 0, 36, 1, 4, 41
"c:\Users\oguzk\Desktop\visual studio\petilla_app_project\petilla_app_project\lib\apps\main_petilla\service\models\jsons\city_model.dart", "Dart", 0, 0, 0, 0, 36, 0, 10, 46
"c:\Users\oguzk\Desktop\visual studio\petilla_app_project\petilla_app_project\lib\apps\main_petilla\service\models\pet_model.dart", "Dart", 0, 0, 0, 0, 32, 0, 2, 34
"c:\Users\oguzk\Desktop\visual studio\petilla_app_project\petilla_app_project\lib\apps\main_petilla\service\storage_service.dart\storage_crud.dart", "Dart", 0, 0, 0, 0, 21, 0, 5, 26
"c:\Users\oguzk\Desktop\visual studio\petilla_app_project\petilla_app_project\lib\apps\main_petilla\view\add_view.dart", "Dart", 0, 0, 0, 0, 246, 4, 26, 276
"c:\Users\oguzk\Desktop\visual studio\petilla_app_project\petilla_app_project\lib\apps\main_petilla\view\add_view_two.dart", "Dart", 0, 0, 0, 0, 352, 1, 41, 394
"c:\Users\oguzk\Desktop\visual studio\petilla_app_project\petilla_app_project\lib\apps\main_petilla\view\chat_select_view.dart", "Dart", 0, 0, 0, 0, 110, 0, 14, 124
"c:\Users\oguzk\Desktop\visual studio\petilla_app_project\petilla_app_project\lib\apps\main_petilla\view\city_select_view.dart", "Dart", 0, 0, 0, 0, 29, 1, 4, 34
"c:\Users\oguzk\Desktop\visual studio\petilla_app_project\petilla_app_project\lib\apps\main_petilla\view\favorites_view.dart", "Dart", 0, 0, 0, 0, 115, 2, 19, 136
"c:\Users\oguzk\Desktop\visual studio\petilla_app_project\petilla_app_project\lib\apps\main_petilla\view\ilce_select_view.dart", "Dart", 0, 0, 0, 0, 33, 1, 8, 42
"c:\Users\oguzk\Desktop\visual studio\petilla_app_project\petilla_app_project\lib\apps\main_petilla\view\in_chat_view.dart", "Dart", 0, 0, 0, 0, 181, 0, 21, 202
"c:\Users\oguzk\Desktop\visual studio\petilla_app_project\petilla_app_project\lib\apps\main_petilla\view\petilla_detail_view.dart", "Dart", 0, 0, 0, 0, 191, 0, 30, 221
"c:\Users\oguzk\Desktop\visual studio\petilla_app_project\petilla_app_project\lib\apps\main_petilla\view\petilla_home_view.dart", "Dart", 0, 0, 0, 0, 390, 0, 34, 424
"c:\Users\oguzk\Desktop\visual studio\petilla_app_project\petilla_app_project\lib\apps\main_petilla\view\petilla_insert_view.dart", "Dart", 0, 0, 0, 0, 101, 0, 15, 116
"c:\Users\oguzk\Desktop\visual studio\petilla_app_project\petilla_app_project\lib\apps\main_petilla\viewmodel\add_view_model.dart", "Dart", 0, 0, 0, 0, 16, 0, 2, 18
"c:\Users\oguzk\Desktop\visual studio\petilla_app_project\petilla_app_project\lib\apps\main_petilla\viewmodel\add_view_two_view_model.dart", "Dart", 0, 0, 0, 0, 54, 0, 2, 56
"c:\Users\oguzk\Desktop\visual studio\petilla_app_project\petilla_app_project\lib\apps\main_petilla\viewmodel\petilla_detail_view_model.dart", "Dart", 0, 0, 0, 0, 19, 0, 2, 21
"c:\Users\oguzk\Desktop\visual studio\petilla_app_project\petilla_app_project\lib\apps\main_petilla\viewmodel\petilla_home_view_model.dart", "Dart", 0, 0, 0, 0, 0, 0, 2, 2
"c:\Users\oguzk\Desktop\visual studio\petilla_app_project\petilla_app_project\lib\apps\main_petilla\viewmodel\petilla_insert_view_model.dart", "Dart", 0, 0, 0, 0, 0, 0, 2, 2
"c:\Users\oguzk\Desktop\visual studio\petilla_app_project\petilla_app_project\lib\apps\pet_form\pet_form_view\petform_group\group_template_view.dart", "Dart", 0, 0, 0, 0, -160, 0, -18, -178
"c:\Users\oguzk\Desktop\visual studio\petilla_app_project\petilla_app_project\lib\apps\pet_form\pet_form_view\petform_group\group_template_view_model.dart", "Dart", 0, 0, 0, 0, -24, 0, -3, -27
"c:\Users\oguzk\Desktop\visual studio\petilla_app_project\petilla_app_project\lib\apps\pet_form\pet_form_view\petform_home\petform_home_view.dart", "Dart", 0, 0, 0, 0, -134, 0, -14, -148
"c:\Users\oguzk\Desktop\visual studio\petilla_app_project\petilla_app_project\lib\apps\pet_form\pet_form_view\petform_home\petform_home_view_model.dart", "Dart", 0, 0, 0, 0, 0, 0, -2, -2
"c:\Users\oguzk\Desktop\visual studio\petilla_app_project\petilla_app_project\lib\apps\pet_form\service\group_message_service.dart", "Dart", 0, 0, 0, 0, 17, 0, 2, 19
"c:\Users\oguzk\Desktop\visual studio\petilla_app_project\petilla_app_project\lib\apps\pet_form\view\group_template_view.dart", "Dart", 0, 0, 0, 0, 178, 0, 22, 200
"c:\Users\oguzk\Desktop\visual studio\petilla_app_project\petilla_app_project\lib\apps\pet_form\view\petform_home_view.dart", "Dart", 0, 0, 0, 0, 135, 0, 14, 149
"c:\Users\oguzk\Desktop\visual studio\petilla_app_project\petilla_app_project\lib\apps\pet_form\viewmodel\group_template_view_model.dart", "Dart", 0, 0, 0, 0, 14, 0, 3, 17
"c:\Users\oguzk\Desktop\visual studio\petilla_app_project\petilla_app_project\lib\apps\pet_form\viewmodel\petform_home_view_model.dart", "Dart", 0, 0, 0, 0, 0, 0, 2, 2
"c:\Users\oguzk\Desktop\visual studio\petilla_app_project\petilla_app_project\lib\apps\pet_media\main_pet_media.dart", "Dart", 0, 0, 0, 0, -14, 0, -3, -17
"c:\Users\oguzk\Desktop\visual studio\petilla_app_project\petilla_app_project\lib\auth\auth_service\auth_service.dart", "Dart", 0, 0, 0, 0, -40, 0, -6, -46
"c:\Users\oguzk\Desktop\visual studio\petilla_app_project\petilla_app_project\lib\auth\auth_view\login_view\login_view.dart", "Dart", 0, 0, 0, 0, -125, -1, -17, -143
"c:\Users\oguzk\Desktop\visual studio\petilla_app_project\petilla_app_project\lib\auth\auth_view\login_view\login_view_model.dart", "Dart", 0, 0, 0, 0, -21, 0, -2, -23
"c:\Users\oguzk\Desktop\visual studio\petilla_app_project\petilla_app_project\lib\auth\auth_view\register_view\register_view.dart", "Dart", 0, 0, 0, 0, -136, -1, -20, -157
"c:\Users\oguzk\Desktop\visual studio\petilla_app_project\petilla_app_project\lib\auth\auth_view\register_view\register_view_model.dart", "Dart", 0, 0, 0, 0, -23, 0, -2, -25
"c:\Users\oguzk\Desktop\visual studio\petilla_app_project\petilla_app_project\lib\auth\onboard\view\onboarding.dart", "Dart", 0, 0, 0, 0, 138, 3, 20, 161
"c:\Users\oguzk\Desktop\visual studio\petilla_app_project\petilla_app_project\lib\auth\onboard\view\onboarding_one_view.dart", "Dart", 0, 0, 0, 0, 40, 1, 6, 47
"c:\Users\oguzk\Desktop\visual studio\petilla_app_project\petilla_app_project\lib\auth\onboard\view\onboarding_three_view.dart", "Dart", 0, 0, 0, 0, 40, 1, 7, 48
"c:\Users\oguzk\Desktop\visual studio\petilla_app_project\petilla_app_project\lib\auth\onboard\view\onboarding_two_view.dart", "Dart", 0, 0, 0, 0, 40, 1, 7, 48
"c:\Users\oguzk\Desktop\visual studio\petilla_app_project\petilla_app_project\lib\auth\onboard\viewmodel\onboarding_view_model.dart", "Dart", 0, 0, 0, 0, 14, 0, 2, 16
"c:\Users\oguzk\Desktop\visual studio\petilla_app_project\petilla_app_project\lib\auth\service\auth_service.dart", "Dart", 0, 0, 0, 0, 40, 0, 6, 46
"c:\Users\oguzk\Desktop\visual studio\petilla_app_project\petilla_app_project\lib\auth\view\login_view.dart", "Dart", 0, 0, 0, 0, 126, 1, 17, 144
"c:\Users\oguzk\Desktop\visual studio\petilla_app_project\petilla_app_project\lib\auth\view\register_view.dart", "Dart", 0, 0, 0, 0, 137, 1, 20, 158
"c:\Users\oguzk\Desktop\visual studio\petilla_app_project\petilla_app_project\lib\auth\viewmodel\login_view_model.dart", "Dart", 0, 0, 0, 0, 22, 0, 2, 24
"c:\Users\oguzk\Desktop\visual studio\petilla_app_project\petilla_app_project\lib\auth\viewmodel\register_view_model.dart", "Dart", 0, 0, 0, 0, 23, 0, 2, 25
"c:\Users\oguzk\Desktop\visual studio\petilla_app_project\petilla_app_project\lib\constant\localization\localization.dart", "Dart", 0, 0, 0, 0, -73, 0, -2, -75
"c:\Users\oguzk\Desktop\visual studio\petilla_app_project\petilla_app_project\lib\constant\other_constant\icon_names.dart", "Dart", 0, 0, 0, 0, -28, 0, -2, -30
"c:\Users\oguzk\Desktop\visual studio\petilla_app_project\petilla_app_project\lib\constant\sizes_constant\app_sized_box.dart", "Dart", 0, 0, 0, 0, -7, 0, -2, -9
"c:\Users\oguzk\Desktop\visual studio\petilla_app_project\petilla_app_project\lib\constant\sizes_constant\project_button_sizes.dart", "Dart", 0, 0, 0, 0, -4, 0, -1, -5
"c:\Users\oguzk\Desktop\visual studio\petilla_app_project\petilla_app_project\lib\constant\sizes_constant\project_card_sizes.dart", "Dart", 0, 0, 0, 0, -8, 0, -1, -9
"c:\Users\oguzk\Desktop\visual studio\petilla_app_project\petilla_app_project\lib\constant\sizes_constant\project_icon_sizes.dart", "Dart", 0, 0, 0, 0, -5, 0, -1, -6
"c:\Users\oguzk\Desktop\visual studio\petilla_app_project\petilla_app_project\lib\constant\sizes_constant\project_padding.dart", "Dart", 0, 0, 0, 0, -9, 0, -2, -11
"c:\Users\oguzk\Desktop\visual studio\petilla_app_project\petilla_app_project\lib\constant\sizes_constant\project_radius.dart", "Dart", 0, 0, 0, 0, -6, 0, -2, -8
"c:\Users\oguzk\Desktop\visual studio\petilla_app_project\petilla_app_project\lib\constant\strings_constant\app_firestore_field_names.dart", "Dart", 0, 0, 0, 0, -27, 0, -1, -28
"c:\Users\oguzk\Desktop\visual studio\petilla_app_project\petilla_app_project\lib\constant\strings_constant\locale_constants.dart", "Dart", 0, 0, 0, 0, -3, 0, -1, -4
"c:\Users\oguzk\Desktop\visual studio\petilla_app_project\petilla_app_project\lib\constant\strings_constant\project_firestore_collection_names.dart", "Dart", 0, 0, 0, 0, -6, -2, -2, -10
"c:\Users\oguzk\Desktop\visual studio\petilla_app_project\petilla_app_project\lib\constant\strings_constant\project_lottie_urls.dart", "Dart", 0, 0, 0, 0, -7, 0, -1, -8
"c:\Users\oguzk\Desktop\visual studio\petilla_app_project\petilla_app_project\lib\constant\strings_constant\shared_preferences_key_constants.dart", "Dart", 0, 0, 0, 0, -3, 0, -1, -4
"c:\Users\oguzk\Desktop\visual studio\petilla_app_project\petilla_app_project\lib\core\base\state\base_state.dart", "Dart", 0, 0, 0, 0, 6, 0, 2, 8
"c:\Users\oguzk\Desktop\visual studio\petilla_app_project\petilla_app_project\lib\core\base\view\profile_view.dart", "Dart", 0, 0, 0, 0, 114, 0, 14, 128
"c:\Users\oguzk\Desktop\visual studio\petilla_app_project\petilla_app_project\lib\core\base\view\status_view.dart", "Dart", 0, 0, 0, 0, 31, 0, 5, 36
"c:\Users\oguzk\Desktop\visual studio\petilla_app_project\petilla_app_project\lib\core\base\viewmodel\profile_view_model.dart", "Dart", 0, 0, 0, 0, 16, 0, 2, 18
"c:\Users\oguzk\Desktop\visual studio\petilla_app_project\petilla_app_project\lib\core\components\button.dart", "Dart", 0, 0, 0, 0, 45, 0, 6, 51
"c:\Users\oguzk\Desktop\visual studio\petilla_app_project\petilla_app_project\lib\core\components\dialogs\default_dialog.dart", "Dart", 0, 0, 0, 0, 14, 0, 2, 16
"c:\Users\oguzk\Desktop\visual studio\petilla_app_project\petilla_app_project\lib\core\components\dialogs\error_dialog.dart", "Dart", 0, 0, 0, 0, 19, 0, 3, 22
"c:\Users\oguzk\Desktop\visual studio\petilla_app_project\petilla_app_project\lib\core\components\single_message.dart", "Dart", 0, 0, 0, 0, 36, 0, 5, 41
"c:\Users\oguzk\Desktop\visual studio\petilla_app_project\petilla_app_project\lib\core\components\textfields\auth_textfield.dart", "Dart", 0, 0, 0, 0, 77, 0, 9, 86
"c:\Users\oguzk\Desktop\visual studio\petilla_app_project\petilla_app_project\lib\core\components\textfields\main_textfield.dart", "Dart", 0, 0, 0, 0, 62, 0, 4, 66
"c:\Users\oguzk\Desktop\visual studio\petilla_app_project\petilla_app_project\lib\core\constants\app\app_constants.dart", "Dart", 0, 0, 0, 0, 3, 1, 2, 6
"c:\Users\oguzk\Desktop\visual studio\petilla_app_project\petilla_app_project\lib\core\constants\enums\file_type_enum.dart", "Dart", 0, 0, 0, 0, 11, 1, 2, 14
"c:\Users\oguzk\Desktop\visual studio\petilla_app_project\petilla_app_project\lib\core\constants\enums\locale_keys_enum.dart", "Dart", 0, 0, 0, 0, 1, 1, 2, 4
"c:\Users\oguzk\Desktop\visual studio\petilla_app_project\petilla_app_project\lib\core\constants\enums\status_keys_enum.dart", "Dart", 0, 0, 0, 0, 6, 1, 2, 9
"c:\Users\oguzk\Desktop\visual studio\petilla_app_project\petilla_app_project\lib\core\constants\image\image_constants.dart", "Dart", 0, 0, 0, 0, 19, 0, 4, 23
"c:\Users\oguzk\Desktop\visual studio\petilla_app_project\petilla_app_project\lib\core\constants\other_constant\icon_names.dart", "Dart", 0, 0, 0, 0, 28, 0, 2, 30
"c:\Users\oguzk\Desktop\visual studio\petilla_app_project\petilla_app_project\lib\core\constants\sizes_constant\app_sized_box.dart", "Dart", 0, 0, 0, 0, 7, 0, 2, 9
"c:\Users\oguzk\Desktop\visual studio\petilla_app_project\petilla_app_project\lib\core\constants\sizes_constant\project_button_sizes.dart", "Dart", 0, 0, 0, 0, 4, 0, 1, 5
"c:\Users\oguzk\Desktop\visual studio\petilla_app_project\petilla_app_project\lib\core\constants\sizes_constant\project_card_sizes.dart", "Dart", 0, 0, 0, 0, 8, 0, 1, 9
"c:\Users\oguzk\Desktop\visual studio\petilla_app_project\petilla_app_project\lib\core\constants\sizes_constant\project_icon_sizes.dart", "Dart", 0, 0, 0, 0, 5, 0, 1, 6
"c:\Users\oguzk\Desktop\visual studio\petilla_app_project\petilla_app_project\lib\core\constants\sizes_constant\project_padding.dart", "Dart", 0, 0, 0, 0, 9, 0, 2, 11
"c:\Users\oguzk\Desktop\visual studio\petilla_app_project\petilla_app_project\lib\core\constants\sizes_constant\project_radius.dart", "Dart", 0, 0, 0, 0, 6, 0, 2, 8
"c:\Users\oguzk\Desktop\visual studio\petilla_app_project\petilla_app_project\lib\core\constants\string_constant\app_firestore_field_names.dart", "Dart", 0, 0, 0, 0, 27, 0, 1, 28
"c:\Users\oguzk\Desktop\visual studio\petilla_app_project\petilla_app_project\lib\core\constants\string_constant\path_constants.dart", "Dart", 0, 0, 0, 0, 3, 0, 1, 4
"c:\Users\oguzk\Desktop\visual studio\petilla_app_project\petilla_app_project\lib\core\constants\string_constant\project_firestore_collection_names.dart", "Dart", 0, 0, 0, 0, 6, 2, 2, 10
"c:\Users\oguzk\Desktop\visual studio\petilla_app_project\petilla_app_project\lib\core\constants\string_constant\project_lottie_urls.dart", "Dart", 0, 0, 0, 0, 8, 0, 1, 9
"c:\Users\oguzk\Desktop\visual studio\petilla_app_project\petilla_app_project\lib\core\extension\string_lang_extension.dart", "Dart", 0, 0, 0, 0, 4, 0, 2, 6
"c:\Users\oguzk\Desktop\visual studio\petilla_app_project\petilla_app_project\lib\core\init\cache\locale_manager.dart", "Dart", 0, 0, 0, 0, 19, 1, 6, 26
"c:\Users\oguzk\Desktop\visual studio\petilla_app_project\petilla_app_project\lib\core\init\lang\language_manager.dart", "Dart", 0, 0, 0, 0, 11, 0, 5, 16
"c:\Users\oguzk\Desktop\visual studio\petilla_app_project\petilla_app_project\lib\core\init\lang\locale_keys.g.dart", "Dart", 0, 0, 0, 0, 75, 1, 2, 78
"c:\Users\oguzk\Desktop\visual studio\petilla_app_project\petilla_app_project\lib\core\init\theme\app_theme.dart", "Dart", 0, 0, 0, 0, 4, 0, 2, 6
"c:\Users\oguzk\Desktop\visual studio\petilla_app_project\petilla_app_project\lib\core\init\theme\light_theme\light_theme.dart", "Dart", 0, 0, 0, 0, 60, 6, 12, 78
"c:\Users\oguzk\Desktop\visual studio\petilla_app_project\petilla_app_project\lib\core\init\theme\light_theme\light_theme_colors.dart", "Dart", 0, 0, 0, 0, 14, 0, 2, 16
"c:\Users\oguzk\Desktop\visual studio\petilla_app_project\petilla_app_project\lib\general\general_view\profile_view\profile_view.dart", "Dart", 0, 0, 0, 0, -110, 0, -14, -124
"c:\Users\oguzk\Desktop\visual studio\petilla_app_project\petilla_app_project\lib\general\general_view\profile_view\profile_view_model.dart", "Dart", 0, 0, 0, 0, -16, 0, -2, -18
"c:\Users\oguzk\Desktop\visual studio\petilla_app_project\petilla_app_project\lib\general\general_widgets\button.dart", "Dart", 0, 0, 0, 0, -45, 0, -6, -51
"c:\Users\oguzk\Desktop\visual studio\petilla_app_project\petilla_app_project\lib\general\general_widgets\dialogs\default_dialog.dart", "Dart", 0, 0, 0, 0, -14, 0, -2, -16
"c:\Users\oguzk\Desktop\visual studio\petilla_app_project\petilla_app_project\lib\general\general_widgets\dialogs\error_dialog.dart", "Dart", 0, 0, 0, 0, -18, 0, -3, -21
"c:\Users\oguzk\Desktop\visual studio\petilla_app_project\petilla_app_project\lib\general\general_widgets\single_message.dart", "Dart", 0, 0, 0, 0, -36, 0, -5, -41
"c:\Users\oguzk\Desktop\visual studio\petilla_app_project\petilla_app_project\lib\general\general_widgets\textfields\auth_textfield.dart", "Dart", 0, 0, 0, 0, -75, 0, -9, -84
"c:\Users\oguzk\Desktop\visual studio\petilla_app_project\petilla_app_project\lib\general\general_widgets\textfields\main_textfield.dart", "Dart", 0, 0, 0, 0, -61, 0, -4, -65
"c:\Users\oguzk\Desktop\visual studio\petilla_app_project\petilla_app_project\lib\main.dart", "Dart", 0, 0, 0, 0, 13, -20, 0, -7
"c:\Users\oguzk\Desktop\visual studio\petilla_app_project\petilla_app_project\lib\start\core\components\select_app_widget.dart", "Dart", 0, 0, 0, 0, 64, 0, 7, 71
"c:\Users\oguzk\Desktop\visual studio\petilla_app_project\petilla_app_project\lib\start\onboarding\onboarding.dart", "Dart", 0, 0, 0, 0, -136, -3, -20, -159
"c:\Users\oguzk\Desktop\visual studio\petilla_app_project\petilla_app_project\lib\start\onboarding\onboarding_view_model.dart", "Dart", 0, 0, 0, 0, -18, 0, -2, -20
"c:\Users\oguzk\Desktop\visual studio\petilla_app_project\petilla_app_project\lib\start\onboarding\onboarding_views\onboarding_one\onboarding_one_view.dart", "Dart", 0, 0, 0, 0, -39, -1, -6, -46
"c:\Users\oguzk\Desktop\visual studio\petilla_app_project\petilla_app_project\lib\start\onboarding\onboarding_views\onboarding_one\onboarding_one_view_model.dart", "Dart", 0, 0, 0, 0, 0, 0, -2, -2
"c:\Users\oguzk\Desktop\visual studio\petilla_app_project\petilla_app_project\lib\start\onboarding\onboarding_views\onboarding_three\onboarding_three_view.dart", "Dart", 0, 0, 0, 0, -39, -1, -7, -47
"c:\Users\oguzk\Desktop\visual studio\petilla_app_project\petilla_app_project\lib\start\onboarding\onboarding_views\onboarding_three\onboarding_three_view_model.dart", "Dart", 0, 0, 0, 0, 0, 0, -1, -1
"c:\Users\oguzk\Desktop\visual studio\petilla_app_project\petilla_app_project\lib\start\onboarding\onboarding_views\onboarding_two\onboarding_two_view.dart", "Dart", 0, 0, 0, 0, -39, -1, -7, -47
"c:\Users\oguzk\Desktop\visual studio\petilla_app_project\petilla_app_project\lib\start\onboarding\onboarding_views\onboarding_two\onboarding_two_view_model.dart", "Dart", 0, 0, 0, 0, 0, 0, -2, -2
"c:\Users\oguzk\Desktop\visual studio\petilla_app_project\petilla_app_project\lib\start\select_app_view\select_app_view.dart", "Dart", 0, 0, 0, 0, -109, 0, -13, -122
"c:\Users\oguzk\Desktop\visual studio\petilla_app_project\petilla_app_project\lib\start\select_app_view\select_app_view_model.dart", "Dart", 0, 0, 0, 0, 0, 0, -2, -2
"c:\Users\oguzk\Desktop\visual studio\petilla_app_project\petilla_app_project\lib\start\select_app_view\select_app_widgets\select_app_widget.dart", "Dart", 0, 0, 0, 0, -64, 0, -7, -71
"c:\Users\oguzk\Desktop\visual studio\petilla_app_project\petilla_app_project\lib\start\view\select_app_view.dart", "Dart", 0, 0, 0, 0, 105, 0, 13, 118
"c:\Users\oguzk\Desktop\visual studio\petilla_app_project\petilla_app_project\lib\start\viewmodel\select_app_view_model.dart", "Dart", 0, 0, 0, 0, 0, 0, 2, 2
"c:\Users\oguzk\Desktop\visual studio\petilla_app_project\petilla_app_project\lib\theme\light_theme\light_theme.dart", "Dart", 0, 0, 0, 0, -50, -6, -9, -65
"c:\Users\oguzk\Desktop\visual studio\petilla_app_project\petilla_app_project\lib\theme\light_theme\light_theme_colors.dart", "Dart", 0, 0, 0, 0, -14, 0, -2, -16
"c:\Users\oguzk\Desktop\visual studio\petilla_app_project\petilla_app_project\lib\utility\asset_utils\assets_build_constant\image_build_constant.dart", "Dart", 0, 0, 0, 0, -3, 0, -1, -4
"c:\Users\oguzk\Desktop\visual studio\petilla_app_project\petilla_app_project\lib\utility\asset_utils\assets_build_constant\svg_build_constant.dart", "Dart", 0, 0, 0, 0, -3, 0, -1, -4
"c:\Users\oguzk\Desktop\visual studio\petilla_app_project\petilla_app_project\lib\utility\asset_utils\compress_utils.dart", "Dart", 0, 0, 0, 0, 11, 0, 0, 11
"c:\Users\oguzk\Desktop\visual studio\petilla_app_project\petilla_app_project\lib\utility\widget_utility\fav_button_service.dart", "Dart", 0, 0, 0, 0, 1, 0, 0, 1
"c:\Users\oguzk\Desktop\visual studio\petilla_app_project\petilla_app_project\pubspec.yaml", "YAML", 9, 0, 0, 0, 0, -4, 3, 8
"c:\Users\oguzk\Desktop\visual studio\petilla_app_project\petilla_app_project\scripts\lang.sh", "Shell Script", 0, 0, 1, 0, 0, 0, 1, 2
"Total", "-", 9, 2, 1, 10, 186, -16, 60, 252